WTWWGDT | WTWWGDU | WTWWGDV | WTWWGET | WTWWGEU | WTWWGEV | WTWWGFT | WTWWGFU | WTWWGFV | WTWWHDT | WTWWHDU
WTWWHDV | WTWWHET | WTWWHEU | WTWWHEV | WTWWHFT | WTWWHFU | WTWWHFV | WTWWIDT | WTWWIDU | WTWWIDV | WTWWIET
WTWWIEU | WTWWIEV | WTWWIFT | WTWWIFU | WTWWIFV | WTWXGDT | WTWXGDU | WTWXGDV | WTWXGET | WTWXGEU | WTWXGEV
WTWXGFT | WTWXGFU | WTWXGFV | WTWXHDT | WTWXHDU | WTWXHDV | WTWXHET | WTWXHEU | WTWXHEV | WTWXHFT | WTWXHFU
WTWXHFV | WTWXIDT | WTWXIDU | WTWXIDV | WTWXIET | WTWXIEU | WTWXIEV | WTWXIFT | WTWXIFU | WTWXIFV | WTWYGDT
WTWYGDU | WTWYGDV | WTWYGET | WTWYGEU | WTWYGEV | WTWYGFT | WTWYGFU | WTWYGFV | WTWYHDT | WTWYHDU | WTWYHDV
WTWYHET | WTWYHEU | WTWYHEV | WTWYHFT | WTWYHFU | WTWYHFV | WTWYIDT | WTWYIDU | WTWYIDV | WTWYIET | WTWYIEU
WTWYIEV | WTWYIFT | WTWYIFU | WTWYIFV | WTWZGDT | WTWZGDU | WTWZGDV | WTWZGET | WTWZGEU | WTWZGEV | WTWZGFT
WTWZGFU | WTWZGFV | WTWZHDT | WTWZHDU | WTWZHDV | WTWZHET | WTWZHEU | WTWZHEV | WTWZHFT | WTWZHFU | WTWZHFV
WTWZIDT | WTWZIDU | WTWZIDV | WTWZIET | WTWZIEU | WTWZIEV | WTWZIFT | WTWZIFU | WTWZIFV | WTXWGDT | WTXWGDU
WTXWGDV | WTXWGET | WTXWGEU | WTXWGEV | WTXWGFT | WTXWGFU | WTXWGFV | WTXWHDT | WTXWHDU | WTXWHDV | WTXWHET
WTXWHEU | WTXWHEV | WTXWHFT | WTXWHFU | WTXWHFV | WTXWIDT | WTXWIDU | WTXWIDV | WTXWIET | WTXWIEU | WTXWIEV
WTXWIFT | WTXWIFU | WTXWIFV | WTXXGDT | WTXXGDU | WTXXGDV | WTXXGET | WTXXGEU | WTXXGEV | WTXXGFT | WTXXGFU
WTXXGFV | WTXXHDT | WTXXHDU | WTXXHDV | WTXXHET | WTXXHEU | WTXXHEV | WTXXHFT | WTXXHFU | WTXXHFV | WTXXIDT
WTXXIDU | WTXXIDV | WTXXIET | WTXXIEU | WTXXIEV | WTXXIFT | WTXXIFU | WTXXIFV | WTXYGDT | WTXYGDU | WTXYGDV
WTXYGET | WTXYGEU | WTXYGEV | WTXYGFT | WTXYGFU | WTXYGFV | WTXYHDT | WTXYHDU | WTXYHDV | WTXYHET | WTXYHEU
WTXYHEV | WTXYHFT | WTXYHFU | WTXYHFV | WTXYIDT | WTXYIDU | WTXYIDV | WTXYIET | WTXYIEU | WTXYIEV | WTXYIFT
WTXYIFU | WTXYIFV | WTXZGDT | WTXZGDU | WTXZGDV | WTXZGET | WTXZGEU | WTXZGEV | WTXZGFT | WTXZGFU | WTXZGFV
WTXZHDT | WTXZHDU | WTXZHDV | WTXZHET | WTXZHEU | WTXZHEV | WTXZHFT | WTXZHFU | WTXZHFV | WTXZIDT | WTXZIDU
WTXZIDV | WTXZIET | WTXZIEU | WTXZIEV | WTXZIFT | WTXZIFU | WTXZIFV | WTYWGDT | WTYWGDU | WTYWGDV | WTYWGET
WTYWGEU | WTYWGEV | WTYWGFT | WTYWGFU | WTYWGFV | WTYWHDT | WTYWHDU | WTYWHDV | WTYWHET | WTYWHEU | WTYWHEV
WTYWHFT | WTYWHFU | WTYWHFV | WTYWIDT | WTYWIDU | WTYWIDV | WTYWIET | WTYWIEU | WTYWIEV | WTYWIFT | WTYWIFU
WTYWIFV | WTYXGDT | WTYXGDU | WTYXGDV | WTYXGET | WTYXGEU | WTYXGEV | WTYXGFT | WTYXGFU | WTYXGFV | WTYXHDT
WTYXHDU | WTYXHDV | WTYXHET | WTYXHEU | WTYXHEV | WTYXHFT | WTYXHFU | WTYXHFV | WTYXIDT | WTYXIDU | WTYXIDV
WTYXIET | WTYXIEU | WTYXIEV | WTYXIFT | WTYXIFU | WTYXIFV | WTYYGDT | WTYYGDU | WTYYGDV | WTYYGET | WTYYGEU
WTYYGEV | WTYYGFT | WTYYGFU | WTYYGFV | WTYYHDT | WTYYHDU | WTYYHDV | WTYYHET | WTYYHEU | WTYYHEV | WTYYHFT
WTYYHFU | WTYYHFV | WTYYIDT | WTYYIDU | WTYYIDV | WTYYIET | WTYYIEU | WTYYIEV | WTYYIFT | WTYYIFU | WTYYIFV
WTYZGDT | WTYZGDU | WTYZGDV | WTYZGET | WTYZGEU | WTYZGEV | WTYZGFT | WTYZGFU | WTYZGFV | WTYZHDT | WTYZHDU
WTYZHDV | WTYZHET | WTYZHEU | WTYZHEV | WTYZHFT | WTYZHFU | WTYZHFV | WTYZIDT | WTYZIDU | WTYZIDV | WTYZIET
WTYZIEU | WTYZIEV | WTYZIFT | WTYZIFU | WTYZIFV | WTZWGDT | WTZWGDU | WTZWGDV | WTZWGET | WTZWGEU | WTZWGEV
WTZWGFT | WTZWGFU | WTZWGFV | WTZWHDT | WTZWHDU | WTZWHDV | WTZWHET | WTZWHEU | WTZWHEV | WTZWHFT | WTZWHFU
WTZWHFV | WTZWIDT | WTZWIDU | WTZWIDV | WTZWIET | WTZWIEU | WTZWIEV | WTZWIFT | WTZWIFU | WTZWIFV | WTZXGDT
WTZXGDU | WTZXGDV | WTZXGET | WTZXGEU | WTZXGEV | WTZXGFT | WTZXGFU | WTZXGFV | WTZXHDT | WTZXHDU | WTZXHDV
WTZXHET | WTZXHEU | WTZXHEV | WTZXHFT | WTZXHFU | WTZXHFV | WTZXIDT | WTZXIDU | WTZXIDV | WTZXIET | WTZXIEU
WTZXIEV | WTZXIFT | WTZXIFU | WTZXIFV | WTZYGDT | WTZYGDU | WTZYGDV | WTZYGET | WTZYGEU | WTZYGEV | WTZYGFT
WTZYGFU | WTZYGFV | WTZYHDT | WTZYHDU | WTZYHDV | WTZYHET | WTZYHEU | WTZYHEV | WTZYHFT | WTZYHFU | WTZYHFV
WTZYIDT | WTZYIDU | WTZYIDV | WTZYIET | WTZYIEU | WTZYIEV | WTZYIFT | WTZYIFU | WTZYIFV | WTZZGDT | WTZZGDU
WTZZGDV | WTZZGET | WTZZGEU | WTZZGEV | WTZZGFT | WTZZGFU | WTZZGFV | WTZZHDT | WTZZHDU | WTZZHDV | WTZZHET
WTZZHEU | WTZZHEV | WTZZHFT | WTZZHFU | WTZZHFV | WTZZIDT | WTZZIDU | WTZZIDV | WTZZIET | WTZZIEU | WTZZIEV
WTZZIFT | WTZZIFU | WTZZIFV | WUWWGDT | WUWWGDU | WUWWGDV | WUWWGET | WUWWGEU | WUWWGEV | WUWWGFT | WUWWGFU
WUWWGFV | WUWWHDT | WUWWHDU | WUWWHDV | WUWWHET | WUWWHEU | WUWWHEV | WUWWHFT | WUWWHFU | WUWWHFV | WUWWIDT
WUWWIDU | WUWWIDV | WUWWIET | WUWWIEU | WUWWIEV | WUWWIFT | WUWWIFU | WUWWIFV | WUWXGDT | WUWXGDU | WUWXGDV
WUWXGET | WUWXGEU | WUWXGEV | WUWXGFT | WUWXGFU | WUWXGFV | WUWXHDT | WUWXHDU | WUWXHDV | WUWXHET | WUWXHEU
WUWXHEV | WUWXHFT | WUWXHFU | WUWXHFV | WUWXIDT | WUWXIDU | WUWXIDV | WUWXIET | WUWXIEU | WUWXIEV | WUWXIFT
WUWXIFU | WUWXIFV | WUWYGDT | WUWYGDU | WUWYGDV | WUWYGET | WUWYGEU | WUWYGEV | WUWYGFT | WUWYGFU | WUWYGFV
WUWYHDT | WUWYHDU | WUWYHDV | WUWYHET | WUWYHEU | WUWYHEV | WUWYHFT | WUWYHFU | WUWYHFV | WUWYIDT | WUWYIDU
WUWYIDV | WUWYIET | WUWYIEU | WUWYIEV | WUWYIFT | WUWYIFU | WUWYIFV | WUWZGDT | WUWZGDU | WUWZGDV | WUWZGET
WUWZGEU | WUWZGEV | WUWZGFT | WUWZGFU | WUWZGFV | WUWZHDT | WUWZHDU | WUWZHDV | WUWZHET | WUWZHEU | WUWZHEV
WUWZHFT | WUWZHFU | WUWZHFV | WUWZIDT | WUWZIDU | WUWZIDV | WUWZIET | WUWZIEU | WUWZIEV | WUWZIFT | WUWZIFU
WUWZIFV | WUXWGDT | WUXWGDU | WUXWGDV | WUXWGET | WUXWGEU | WUXWGEV | WUXWGFT | WUXWGFU | WUXWGFV | WUXWHDT
WUXWHDU | WUXWHDV | WUXWHET | WUXWHEU | WUXWHEV | WUXWHFT | WUXWHFU | WUXWHFV | WUXWIDT | WUXWIDU | WUXWIDV
WUXWIET | WUXWIEU | WUXWIEV | WUXWIFT | WUXWIFU | WUXWIFV | WUXXGDT | WUXXGDU | WUXXGDV | WUXXGET | WUXXGEU
WUXXGEV | WUXXGFT | WUXXGFU | WUXXGFV | WUXXHDT | WUXXHDU | WUXXHDV | WUXXHET | WUXXHEU | WUXXHEV | WUXXHFT
WUXXHFU | WUXXHFV | WUXXIDT | WUXXIDU | WUXXIDV | WUXXIET | WUXXIEU | WUXXIEV | WUXXIFT | WUXXIFU | WUXXIFV
WUXYGDT | WUXYGDU | WUXYGDV | WUXYGET | WUXYGEU | WUXYGEV | WUXYGFT | WUXYGFU | WUXYGFV | WUXYHDT | WUXYHDU
WUXYHDV | WUXYHET | WUXYHEU | WUXYHEV | WUXYHFT | WUXYHFU | WUXYHFV | WUXYIDT | WUXYIDU | WUXYIDV | WUXYIET
WUXYIEU | WUXYIEV | WUXYIFT | WUXYIFU | WUXYIFV | WUXZGDT | WUXZGDU | WUXZGDV | WUXZGET | WUXZGEU | WUXZGEV
WUXZGFT | WUXZGFU | WUXZGFV | WUXZHDT | WUXZHDU | WUXZHDV | WUXZHET | WUXZHEU | WUXZHEV | WUXZHFT | WUXZHFU
WUXZHFV | WUXZIDT | WUXZIDU | WUXZIDV | WUXZIET | WUXZIEU | WUXZIEV | WUXZIFT | WUXZIFU | WUXZIFV | WUYWGDT
WUYWGDU | WUYWGDV | WUYWGET | WUYWGEU | WUYWGEV | WUYWGFT | WUYWGFU | WUYWGFV | WUYWHDT | WUYWHDU | WUYWHDV
WUYWHET | WUYWHEU | WUYWHEV | WUYWHFT | WUYWHFU | WUYWHFV | WUYWIDT | WUYWIDU | WUYWIDV | WUYWIET | WUYWIEU
WUYWIEV | WUYWIFT | WUYWIFU | WUYWIFV | WUYXGDT | WUYXGDU | WUYXGDV | WUYXGET | WUYXGEU | WUYXGEV | WUYXGFT
WUYXGFU | WUYXGFV | WUYXHDT | WUYXHDU | WUYXHDV | WUYXHET | WUYXHEU | WUYXHEV | WUYXHFT | WUYXHFU | WUYXHFV
WUYXIDT | WUYXIDU | WUYXIDV | WUYXIET | WUYXIEU | WUYXIEV | WUYXIFT | WUYXIFU | WUYXIFV | WUYYGDT | WUYYGDU
WUYYGDV | WUYYGET | WUYYGEU | WUYYGEV | WUYYGFT | WUYYGFU | WUYYGFV | WUYYHDT | WUYYHDU | WUYYHDV | WUYYHET
WUYYHEU | WUYYHEV | WUYYHFT | WUYYHFU | WUYYHFV | WUYYIDT | WUYYIDU | WUYYIDV | WUYYIET | WUYYIEU | WUYYIEV
WUYYIFT | WUYYIFU | WUYYIFV | WUYZGDT | WUYZGDU | WUYZGDV | WUYZGET | WUYZGEU | WUYZGEV | WUYZGFT | WUYZGFU
WUYZGFV | WUYZHDT | WUYZHDU | WUYZHDV | WUYZHET | WUYZHEU | WUYZHEV | WUYZHFT | WUYZHFU | WUYZHFV | WUYZIDT
WUYZIDU | WUYZIDV | WUYZIET | WUYZIEU | WUYZIEV | WUYZIFT | WUYZIFU | WUYZIFV | WUZWGDT | WUZWGDU | WUZWGDV
WUZWGET | WUZWGEU | WUZWGEV | WUZWGFT | WUZWGFU | WUZWGFV | WUZWHDT | WUZWHDU | WUZWHDV | WUZWHET | WUZWHEU
WUZWHEV | WUZWHFT | WUZWHFU | WUZWHFV | WUZWIDT | WUZWIDU | WUZWIDV | WUZWIET | WUZWIEU | WUZWIEV | WUZWIFT
WUZWIFU | WUZWIFV | WUZXGDT | WUZXGDU | WUZXGDV | WUZXGET | WUZXGEU | WUZXGEV | WUZXGFT | WUZXGFU | WUZXGFV
WUZXHDT | WUZXHDU | WUZXHDV | WUZXHET | WUZXHEU | WUZXHEV | WUZXHFT | WUZXHFU | WUZXHFV | WUZXIDT | WUZXIDU
WUZXIDV | WUZXIET | WUZXIEU | WUZXIEV | WUZXIFT | WUZXIFU | WUZXIFV | WUZYGDT | WUZYGDU | WUZYGDV | WUZYGET
WUZYGEU | WUZYGEV | WUZYGFT | WUZYGFU | WUZYGFV | WUZYHDT | WUZYHDU | WUZYHDV | WUZYHET | WUZYHEU | WUZYHEV
WUZYHFT | WUZYHFU | WUZYHFV | WUZYIDT | WUZYIDU | WUZYIDV | WUZYIET | WUZYIEU | WUZYIEV | WUZYIFT | WUZYIFU
WUZYIFV | WUZZGDT | WUZZGDU | WUZZGDV | WUZZGET | WUZZGEU | WUZZGEV | WUZZGFT | WUZZGFU | WUZZGFV | WUZZHDT
WUZZHDU | WUZZHDV | WUZZHET | WUZZHEU | WUZZHEV | WUZZHFT | WUZZHFU | WUZZHFV | WUZZIDT | WUZZIDU | WUZZIDV
WUZZIET | WUZZIEU | WUZZIEV | WUZZIFT | WUZZIFU | WUZZIFV | WVWWGDT | WVWWGDU | WVWWGDV | WVWWGET | WVWWGEU
WVWWGEV | WVWWGFT | WVWWGFU | WVWWGFV | WVWWHDT | WVWWHDU | WVWWHDV | WVWWHET | WVWWHEU | WVWWHEV | WVWWHFT
WVWWHFU | WVWWHFV | WVWWIDT | WVWWIDU | WVWWIDV | WVWWIET | WVWWIEU | WVWWIEV | WVWWIFT | WVWWIFU | WVWWIFV
WVWXGDT | WVWXGDU | WVWXGDV | WVWXGET | WVWXGEU | WVWXGEV | WVWXGFT | WVWXGFU | WVWXGFV | WVWXHDT | WVWXHDU
WVWXHDV | WVWXHET | WVWXHEU | WVWXHEV | WVWXHFT | WVWXHFU | WVWXHFV | WVWXIDT | WVWXIDU | WVWXIDV | WVWXIET
WVWXIEU | WVWXIEV | WVWXIFT | WVWXIFU | WVWXIFV | WVWYGDT | WVWYGDU | WVWYGDV | WVWYGET | WVWYGEU | WVWYGEV
WVWYGFT | WVWYGFU | WVWYGFV | WVWYHDT | WVWYHDU | WVWYHDV | WVWYHET | WVWYHEU | WVWYHEV | WVWYHFT | WVWYHFU
WVWYHFV | WVWYIDT | WVWYIDU | WVWYIDV | WVWYIET | WVWYIEU | WVWYIEV | WVWYIFT | WVWYIFU | WVWYIFV | WVWZGDT
WVWZGDU | WVWZGDV | WVWZGET | WVWZGEU | WVWZGEV | WVWZGFT | WVWZGFU | WVWZGFV | WVWZHDT | WVWZHDU | WVWZHDV
WVWZHET | WVWZHEU | WVWZHEV | WVWZHFT | WVWZHFU | WVWZHFV | WVWZIDT | WVWZIDU | WVWZIDV | WVWZIET | WVWZIEU
WVWZIEV | WVWZIFT | WVWZIFU | WVWZIFV | WVXWGDT | WVXWGDU | WVXWGDV | WVXWGET | WVXWGEU | WVXWGEV | WVXWGFT
WVXWGFU | WVXWGFV | WVXWHDT | WVXWHDU | WVXWHDV | WVXWHET | WVXWHEU | WVXWHEV | WVXWHFT | WVXWHFU | WVXWHFV
WVXWIDT | WVXWIDU | WVXWIDV | WVXWIET | WVXWIEU | WVXWIEV | WVXWIFT | WVXWIFU | WVXWIFV | WVXXGDT | WVXXGDU
WVXXGDV | WVXXGET | WVXXGEU | WVXXGEV | WVXXGFT | WVXXGFU | WVXXGFV | WVXXHDT | WVXXHDU | WVXXHDV | WVXXHET
WVXXHEU | WVXXHEV | WVXXHFT | WVXXHFU | WVXXHFV | WVXXIDT | WVXXIDU | WVXXIDV | WVXXIET | WVXXIEU | WVXXIEV
WVXXIFT | WVXXIFU | WVXXIFV | WVXYGDT | WVXYGDU | WVXYGDV | WVXYGET | WVXYGEU | WVXYGEV | WVXYGFT | WVXYGFU
WVXYGFV | WVXYHDT | WVXYHDU | WVXYHDV | WVXYHET | WVXYHEU | WVXYHEV | WVXYHFT | WVXYHFU | WVXYHFV | WVXYIDT
WVXYIDU | WVXYIDV | WVXYIET | WVXYIEU | WVXYIEV | WVXYIFT | WVXYIFU | WVXYIFV | WVXZGDT | WVXZGDU | WVXZGDV
WVXZGET | WVXZGEU | WVXZGEV | WVXZGFT | WVXZGFU | WVXZGFV | WVXZHDT | WVXZHDU | WVXZHDV | WVXZHET | WVXZHEU
WVXZHEV | WVXZHFT | WVXZHFU | WVXZHFV | WVXZIDT | WVXZIDU | WVXZIDV | WVXZIET | WVXZIEU | WVXZIEV | WVXZIFT
WVXZIFU | WVXZIFV | WVYWGDT | WVYWGDU | WVYWGDV | WVYWGET | WVYWGEU | WVYWGEV | WVYWGFT | WVYWGFU | WVYWGFV
WVYWHDT | WVYWHDU | WVYWHDV | WVYWHET | WVYWHEU | WVYWHEV | WVYWHFT | WVYWHFU | WVYWHFV | WVYWIDT | WVYWIDU
WVYWIDV | WVYWIET | WVYWIEU | WVYWIEV | WVYWIFT | WVYWIFU | WVYWIFV | WVYXGDT | WVYXGDU | WVYXGDV | WVYXGET
WVYXGEU | WVYXGEV | WVYXGFT | WVYXGFU | WVYXGFV | WVYXHDT | WVYXHDU | WVYXHDV | WVYXHET | WVYXHEU | WVYXHEV
WVYXHFT | WVYXHFU | WVYXHFV | WVYXIDT | WVYXIDU | WVYXIDV | WVYXIET | WVYXIEU | WVYXIEV | WVYXIFT | WVYXIFU
WVYXIFV | WVYYGDT | WVYYGDU | WVYYGDV | WVYYGET | WVYYGEU | WVYYGEV | WVYYGFT | WVYYGFU | WVYYGFV | WVYYHDT
WVYYHDU | WVYYHDV | WVYYHET | WVYYHEU | WVYYHEV | WVYYHFT | WVYYHFU | WVYYHFV | WVYYIDT | WVYYIDU | WVYYIDV
WVYYIET | WVYYIEU | WVYYIEV | WVYYIFT | WVYYIFU | WVYYIFV | WVYZGDT | WVYZGDU | WVYZGDV | WVYZGET | WVYZGEU
WVYZGEV | WVYZGFT | WVYZGFU | WVYZGFV | WVYZHDT | WVYZHDU | WVYZHDV | WVYZHET | WVYZHEU | WVYZHEV | WVYZHFT
WVYZHFU | WVYZHFV | WVYZIDT | WVYZIDU | WVYZIDV | WVYZIET | WVYZIEU | WVYZIEV | WVYZIFT | WVYZIFU | WVYZIFV
WVZWGDT | WVZWGDU | WVZWGDV | WVZWGET | WVZWGEU | WVZWGEV | WVZWGFT | WVZWGFU | WVZWGFV | WVZWHDT | WVZWHDU
WVZWHDV | WVZWHET | WVZWHEU | WVZWHEV | WVZWHFT | WVZWHFU | WVZWHFV | WVZWIDT | WVZWIDU | WVZWIDV | WVZWIET
WVZWIEU | WVZWIEV | WVZWIFT | WVZWIFU | WVZWIFV | WVZXGDT | WVZXGDU | WVZXGDV | WVZXGET | WVZXGEU | WVZXGEV
WVZXGFT | WVZXGFU | WVZXGFV | WVZXHDT | WVZXHDU | WVZXHDV | WVZXHET | WVZXHEU | WVZXHEV | WVZXHFT | WVZXHFU
WVZXHFV | WVZXIDT | WVZXIDU | WVZXIDV | WVZXIET | WVZXIEU | WVZXIEV | WVZXIFT | WVZXIFU | WVZXIFV | WVZYGDT
WVZYGDU | WVZYGDV | WVZYGET | WVZYGEU | WVZYGEV | WVZYGFT | WVZYGFU | WVZYGFV | WVZYHDT | WVZYHDU | WVZYHDV
WVZYHET | WVZYHEU | WVZYHEV | WVZYHFT | WVZYHFU | WVZYHFV | WVZYIDT | WVZYIDU | WVZYIDV | WVZYIET | WVZYIEU
WVZYIEV | WVZYIFT | WVZYIFU | WVZYIFV | WVZZGDT | WVZZGDU | WVZZGDV | WVZZGET | WVZZGEU | WVZZGEV | WVZZGFT
WVZZGFU | WVZZGFV | WVZZHDT | WVZZHDU | WVZZHDV | WVZZHET | WVZZHEU | WVZZHEV | WVZZHFT | WVZZHFU | WVZZHFV
WVZZIDT | WVZZIDU | WVZZIDV | WVZZIET | WVZZIEU | WVZZIEV | WVZZIFT | WVZZIFU | WVZZIFV | XTWWGDT | XTWWGDU
XTWWGDV | XTWWGET | XTWWGEU | XTWWGEV | XTWWGFT | XTWWGFU | XTWWGFV | XTWWHDT | XTWWHDU | XTWWHDV | XTWWHET
XTWWHEU | XTWWHEV | XTWWHFT | XTWWHFU | XTWWHFV | XTWWIDT | XTWWIDU | XTWWIDV | XTWWIET | XTWWIEU | XTWWIEV
XTWWIFT | XTWWIFU | XTWWIFV | XTWXGDT | XTWXGDU | XTWXGDV | XTWXGET | XTWXGEU | XTWXGEV | XTWXGFT | XTWXGFU
XTWXGFV | XTWXHDT | XTWXHDU | XTWXHDV | XTWXHET | XTWXHEU | XTWXHEV | XTWXHFT | XTWXHFU | XTWXHFV | XTWXIDT
XTWXIDU | XTWXIDV | XTWXIET | XTWXIEU | XTWXIEV | XTWXIFT | XTWXIFU | XTWXIFV | XTWYGDT | XTWYGDU | XTWYGDV
XTWYGET | XTWYGEU | XTWYGEV | XTWYGFT | XTWYGFU | XTWYGFV | XTWYHDT | XTWYHDU | XTWYHDV | XTWYHET | XTWYHEU
XTWYHEV | XTWYHFT | XTWYHFU | XTWYHFV | XTWYIDT | XTWYIDU | XTWYIDV | XTWYIET | XTWYIEU | XTWYIEV | XTWYIFT
XTWYIFU | XTWYIFV | XTWZGDT | XTWZGDU | XTWZGDV | XTWZGET | XTWZGEU | XTWZGEV | XTWZGFT | XTWZGFU | XTWZGFV
XTWZHDT | XTWZHDU | XTWZHDV | XTWZHET | XTWZHEU | XTWZHEV | XTWZHFT | XTWZHFU | XTWZHFV | XTWZIDT | XTWZIDU
XTWZIDV | XTWZIET | XTWZIEU | XTWZIEV | XTWZIFT | XTWZIFU | XTWZIFV | XTXWGDT | XTXWGDU | XTXWGDV | XTXWGET
XTXWGEU | XTXWGEV | XTXWGFT | XTXWGFU | XTXWGFV | XTXWHDT | XTXWHDU | XTXWHDV | XTXWHET | XTXWHEU | XTXWHEV
XTXWHFT | XTXWHFU | XTXWHFV | XTXWIDT | XTXWIDU | XTXWIDV | XTXWIET | XTXWIEU | XTXWIEV | XTXWIFT | XTXWIFU
XTXWIFV | XTXXGDT | XTXXGDU | XTXXGDV | XTXXGET | XTXXGEU | XTXXGEV | XTXXGFT | XTXXGFU | XTXXGFV | XTXXHDT
XTXXHDU | XTXXHDV | XTXXHET | XTXXHEU | XTXXHEV | XTXXHFT | XTXXHFU | XTXXHFV | XTXXIDT | XTXXIDU | XTXXIDV
XTXXIET | XTXXIEU | XTXXIEV | XTXXIFT | XTXXIFU | XTXXIFV | XTXYGDT | XTXYGDU | XTXYGDV | XTXYGET | XTXYGEU
XTXYGEV | XTXYGFT | XTXYGFU | XTXYGFV | XTXYHDT | XTXYHDU | XTXYHDV | XTXYHET | XTXYHEU | XTXYHEV | XTXYHFT
XTXYHFU | XTXYHFV | XTXYIDT | XTXYIDU | XTXYIDV | XTXYIET | XTXYIEU | XTXYIEV | XTXYIFT | XTXYIFU | XTXYIFV
XTXZGDT | XTXZGDU | XTXZGDV | XTXZGET | XTXZGEU | XTXZGEV | XTXZGFT | XTXZGFU | XTXZGFV | XTXZHDT | XTXZHDU
XTXZHDV | XTXZHET | XTXZHEU | XTXZHEV | XTXZHFT | XTXZHFU | XTXZHFV | XTXZIDT | XTXZIDU | XTXZIDV | XTXZIET
XTXZIEU | XTXZIEV | XTXZIFT | XTXZIFU | XTXZIFV | XTYWGDT | XTYWGDU | XTYWGDV | XTYWGET | XTYWGEU | XTYWGEV
XTYWGFT | XTYWGFU | XTYWGFV | XTYWHDT | XTYWHDU | XTYWHDV | XTYWHET | XTYWHEU | XTYWHEV | XTYWHFT | XTYWHFU
XTYWHFV | XTYWIDT | XTYWIDU | XTYWIDV | XTYWIET | XTYWIEU | XTYWIEV | XTYWIFT | XTYWIFU | XTYWIFV | XTYXGDT
XTYXGDU | XTYXGDV | XTYXGET | XTYXGEU | XTYXGEV | XTYXGFT | XTYXGFU | XTYXGFV | XTYXHDT | XTYXHDU | XTYXHDV
XTYXHET | XTYXHEU | XTYXHEV | XTYXHFT | XTYXHFU | XTYXHFV | XTYXIDT | XTYXIDU | XTYXIDV | XTYXIET | XTYXIEU
XTYXIEV | XTYXIFT | XTYXIFU | XTYXIFV | XTYYGDT | XTYYGDU | XTYYGDV | XTYYGET | XTYYGEU | XTYYGEV | XTYYGFT
XTYYGFU | XTYYGFV | XTYYHDT | XTYYHDU | XTYYHDV | XTYYHET | XTYYHEU | XTYYHEV | XTYYHFT | XTYYHFU | XTYYHFV
XTYYIDT | XTYYIDU | XTYYIDV | XTYYIET | XTYYIEU | XTYYIEV | XTYYIFT | XTYYIFU | XTYYIFV | XTYZGDT | XTYZGDU
XTYZGDV | XTYZGET | XTYZGEU | XTYZGEV | XTYZGFT | XTYZGFU | XTYZGFV | XTYZHDT | XTYZHDU | XTYZHDV | XTYZHET
XTYZHEU | XTYZHEV | XTYZHFT | XTYZHFU | XTYZHFV | XTYZIDT | XTYZIDU | XTYZIDV | XTYZIET | XTYZIEU | XTYZIEV
XTYZIFT | XTYZIFU | XTYZIFV | XTZWGDT | XTZWGDU | XTZWGDV | XTZWGET | XTZWGEU | XTZWGEV | XTZWGFT | XTZWGFU
XTZWGFV | XTZWHDT | XTZWHDU | XTZWHDV | XTZWHET | XTZWHEU | XTZWHEV | XTZWHFT | XTZWHFU | XTZWHFV | XTZWIDT
XTZWIDU | XTZWIDV | XTZWIET | XTZWIEU | XTZWIEV | XTZWIFT | XTZWIFU | XTZWIFV | XTZXGDT | XTZXGDU | XTZXGDV
XTZXGET | XTZXGEU | XTZXGEV | XTZXGFT | XTZXGFU | XTZXGFV | XTZXHDT | XTZXHDU | XTZXHDV | XTZXHET | XTZXHEU
XTZXHEV | XTZXHFT | XTZXHFU | XTZXHFV | XTZXIDT | XTZXIDU | XTZXIDV | XTZXIET | XTZXIEU | XTZXIEV | XTZXIFT
XTZXIFU | XTZXIFV | XTZYGDT | XTZYGDU | XTZYGDV | XTZYGET | XTZYGEU | XTZYGEV | XTZYGFT | XTZYGFU | XTZYGFV
XTZYHDT | XTZYHDU | XTZYHDV | XTZYHET | XTZYHEU | XTZYHEV | XTZYHFT | XTZYHFU | XTZYHFV | XTZYIDT | XTZYIDU
XTZYIDV | XTZYIET | XTZYIEU | XTZYIEV | XTZYIFT | XTZYIFU | XTZYIFV | XTZZGDT | XTZZGDU | XTZZGDV | XTZZGET
XTZZGEU | XTZZGEV | XTZZGFT | XTZZGFU | XTZZGFV | XTZZHDT | XTZZHDU | XTZZHDV | XTZZHET | XTZZHEU | XTZZHEV
XTZZHFT | XTZZHFU | XTZZHFV | XTZZIDT | XTZZIDU | XTZZIDV | XTZZIET | XTZZIEU | XTZZIEV | XTZZIFT | XTZZIFU
XTZZIFV | XUWWGDT | XUWWGDU | XUWWGDV | XUWWGET | XUWWGEU | XUWWGEV | XUWWGFT | XUWWGFU | XUWWGFV | XUWWHDT
XUWWHDU | XUWWHDV | XUWWHET | XUWWHEU | XUWWHEV | XUWWHFT | XUWWHFU | XUWWHFV | XUWWIDT | XUWWIDU | XUWWIDV
XUWWIET | XUWWIEU | XUWWIEV | XUWWIFT | XUWWIFU | XUWWIFV | XUWXGDT | XUWXGDU | XUWXGDV | XUWXGET | XUWXGEU
XUWXGEV | XUWXGFT | XUWXGFU | XUWXGFV | XUWXHDT | XUWXHDU | XUWXHDV | XUWXHET | XUWXHEU | XUWXHEV | XUWXHFT
XUWXHFU | XUWXHFV | XUWXIDT | XUWXIDU | XUWXIDV | XUWXIET | XUWXIEU | XUWXIEV | XUWXIFT | XUWXIFU | XUWXIFV
XUWYGDT | XUWYGDU | XUWYGDV | XUWYGET | XUWYGEU | XUWYGEV | XUWYGFT | XUWYGFU | XUWYGFV | XUWYHDT | XUWYHDU
XUWYHDV | XUWYHET | XUWYHEU | XUWYHEV | XUWYHFT | XUWYHFU | XUWYHFV | XUWYIDT | XUWYIDU | XUWYIDV | XUWYIET
XUWYIEU | XUWYIEV | XUWYIFT | XUWYIFU | XUWYIFV | XUWZGDT | XUWZGDU | XUWZGDV | XUWZGET | XUWZGEU | XUWZGEV
XUWZGFT | XUWZGFU | XUWZGFV | XUWZHDT | XUWZHDU | XUWZHDV | XUWZHET | XUWZHEU | XUWZHEV | XUWZHFT | XUWZHFU
XUWZHFV | XUWZIDT | XUWZIDU | XUWZIDV | XUWZIET | XUWZIEU | XUWZIEV | XUWZIFT | XUWZIFU | XUWZIFV | XUXWGDT
XUXWGDU | XUXWGDV | XUXWGET | XUXWGEU | XUXWGEV | XUXWGFT | XUXWGFU | XUXWGFV | XUXWHDT | XUXWHDU | XUXWHDV
XUXWHET | XUXWHEU | XUXWHEV | XUXWHFT | XUXWHFU | XUXWHFV | XUXWIDT | XUXWIDU | XUXWIDV | XUXWIET | XUXWIEU
XUXWIEV | XUXWIFT | XUXWIFU | XUXWIFV | XUXXGDT | XUXXGDU | XUXXGDV | XUXXGET | XUXXGEU | XUXXGEV | XUXXGFT
XUXXGFU | XUXXGFV | XUXXHDT | XUXXHDU | XUXXHDV | XUXXHET | XUXXHEU | XUXXHEV | XUXXHFT | XUXXHFU | XUXXHFV
XUXXIDT | XUXXIDU | XUXXIDV | XUXXIET | XUXXIEU | XUXXIEV | XUXXIFT | XUXXIFU | XUXXIFV | XUXYGDT | XUXYGDU
XUXYGDV | XUXYGET | XUXYGEU | XUXYGEV | XUXYGFT | XUXYGFU | XUXYGFV | XUXYHDT | XUXYHDU | XUXYHDV | XUXYHET
XUXYHEU | XUXYHEV | XUXYHFT | XUXYHFU | XUXYHFV | XUXYIDT | XUXYIDU | XUXYIDV | XUXYIET | XUXYIEU | XUXYIEV
XUXYIFT | XUXYIFU | XUXYIFV | XUXZGDT | XUXZGDU | XUXZGDV | XUXZGET | XUXZGEU | XUXZGEV | XUXZGFT | XUXZGFU
XUXZGFV | XUXZHDT | XUXZHDU | XUXZHDV | XUXZHET | XUXZHEU | XUXZHEV | XUXZHFT | XUXZHFU | XUXZHFV | XUXZIDT
XUXZIDU | XUXZIDV | XUXZIET | XUXZIEU | XUXZIEV | XUXZIFT | XUXZIFU | XUXZIFV | XUYWGDT | XUYWGDU | XUYWGDV
XUYWGET | XUYWGEU | XUYWGEV | XUYWGFT | XUYWGFU | XUYWGFV | XUYWHDT | XUYWHDU | XUYWHDV | XUYWHET | XUYWHEU
XUYWHEV | XUYWHFT | XUYWHFU | XUYWHFV | XUYWIDT | XUYWIDU | XUYWIDV | XUYWIET | XUYWIEU | XUYWIEV | XUYWIFT
XUYWIFU | XUYWIFV | XUYXGDT | XUYXGDU | XUYXGDV | XUYXGET | XUYXGEU | XUYXGEV | XUYXGFT | XUYXGFU | XUYXGFV
XUYXHDT | XUYXHDU | XUYXHDV | XUYXHET | XUYXHEU | XUYXHEV | XUYXHFT | XUYXHFU | XUYXHFV | XUYXIDT | XUYXIDU
XUYXIDV | XUYXIET | XUYXIEU | XUYXIEV | XUYXIFT | XUYXIFU | XUYXIFV | XUYYGDT | XUYYGDU | XUYYGDV | XUYYGET
XUYYGEU | XUYYGEV | XUYYGFT | XUYYGFU | XUYYGFV | XUYYHDT | XUYYHDU | XUYYHDV | XUYYHET | XUYYHEU | XUYYHEV
XUYYHFT | XUYYHFU | XUYYHFV | XUYYIDT | XUYYIDU | XUYYIDV | XUYYIET | XUYYIEU | XUYYIEV | XUYYIFT | XUYYIFU
XUYYIFV | XUYZGDT | XUYZGDU | XUYZGDV | XUYZGET | XUYZGEU | XUYZGEV | XUYZGFT | XUYZGFU | XUYZGFV | XUYZHDT
XUYZHDU | XUYZHDV | XUYZHET | XUYZHEU | XUYZHEV | XUYZHFT | XUYZHFU | XUYZHFV | XUYZIDT | XUYZIDU | XUYZIDV
XUYZIET | XUYZIEU | XUYZIEV | XUYZIFT | XUYZIFU | XUYZIFV | XUZWGDT | XUZWGDU | XUZWGDV | XUZWGET | XUZWGEU
XUZWGEV | XUZWGFT | XUZWGFU | XUZWGFV | XUZWHDT | XUZWHDU | XUZWHDV | XUZWHET | XUZWHEU | XUZWHEV | XUZWHFT
XUZWHFU | XUZWHFV | XUZWIDT | XUZWIDU | XUZWIDV | XUZWIET | XUZWIEU | XUZWIEV | XUZWIFT | XUZWIFU | XUZWIFV
XUZXGDT | XUZXGDU | XUZXGDV | XUZXGET | XUZXGEU | XUZXGEV | XUZXGFT | XUZXGFU | XUZXGFV | XUZXHDT | XUZXHDU
XUZXHDV | XUZXHET | XUZXHEU | XUZXHEV | XUZXHFT | XUZXHFU | XUZXHFV | XUZXIDT | XUZXIDU | XUZXIDV | XUZXIET
XUZXIEU | XUZXIEV | XUZXIFT | XUZXIFU | XUZXIFV | XUZYGDT | XUZYGDU | XUZYGDV | XUZYGET | XUZYGEU | XUZYGEV
XUZYGFT | XUZYGFU | XUZYGFV | XUZYHDT | XUZYHDU | XUZYHDV | XUZYHET | XUZYHEU | XUZYHEV | XUZYHFT | XUZYHFU
XUZYHFV | XUZYIDT | XUZYIDU | XUZYIDV | XUZYIET | XUZYIEU | XUZYIEV | XUZYIFT | XUZYIFU | XUZYIFV | XUZZGDT
XUZZGDU | XUZZGDV | XUZZGET | XUZZGEU | XUZZGEV | XUZZGFT | XUZZGFU | XUZZGFV | XUZZHDT | XUZZHDU | XUZZHDV
XUZZHET | XUZZHEU | XUZZHEV | XUZZHFT | XUZZHFU | XUZZHFV | XUZZIDT | XUZZIDU | XUZZIDV | XUZZIET | XUZZIEU
XUZZIEV | XUZZIFT | XUZZIFU | XUZZIFV | XVWWGDT | XVWWGDU | XVWWGDV | XVWWGET | XVWWGEU | XVWWGEV | XVWWGFT
XVWWGFU | XVWWGFV | XVWWHDT | XVWWHDU | XVWWHDV | XVWWHET | XVWWHEU | XVWWHEV | XVWWHFT | XVWWHFU | XVWWHFV
XVWWIDT | XVWWIDU | XVWWIDV | XVWWIET | XVWWIEU | XVWWIEV | XVWWIFT | XVWWIFU | XVWWIFV | XVWXGDT | XVWXGDU
XVWXGDV | XVWXGET | XVWXGEU | XVWXGEV | XVWXGFT | XVWXGFU | XVWXGFV | XVWXHDT | XVWXHDU | XVWXHDV | XVWXHET
XVWXHEU | XVWXHEV | XVWXHFT | XVWXHFU | XVWXHFV | XVWXIDT | XVWXIDU | XVWXIDV | XVWXIET | XVWXIEU | XVWXIEV
XVWXIFT | XVWXIFU | XVWXIFV | XVWYGDT | XVWYGDU | XVWYGDV | XVWYGET | XVWYGEU | XVWYGEV | XVWYGFT | XVWYGFU
XVWYGFV | XVWYHDT | XVWYHDU | XVWYHDV | XVWYHET | XVWYHEU | XVWYHEV | XVWYHFT | XVWYHFU | XVWYHFV | XVWYIDT
XVWYIDU | XVWYIDV | XVWYIET | XVWYIEU | XVWYIEV | XVWYIFT | XVWYIFU | XVWYIFV | XVWZGDT | XVWZGDU | XVWZGDV
XVWZGET | XVWZGEU | XVWZGEV | XVWZGFT | XVWZGFU | XVWZGFV | XVWZHDT | XVWZHDU | XVWZHDV | XVWZHET | XVWZHEU
XVWZHEV | XVWZHFT | XVWZHFU | XVWZHFV | XVWZIDT | XVWZIDU | XVWZIDV | XVWZIET | XVWZIEU | XVWZIEV | XVWZIFT
XVWZIFU | XVWZIFV | XVXWGDT | XVXWGDU | XVXWGDV | XVXWGET | XVXWGEU | XVXWGEV | XVXWGFT | XVXWGFU | XVXWGFV
XVXWHDT | XVXWHDU | XVXWHDV | XVXWHET | XVXWHEU | XVXWHEV | XVXWHFT | XVXWHFU | XVXWHFV | XVXWIDT | XVXWIDU
XVXWIDV | XVXWIET | XVXWIEU | XVXWIEV | XVXWIFT | XVXWIFU | XVXWIFV | XVXXGDT | XVXXGDU | XVXXGDV | XVXXGET
XVXXGEU | XVXXGEV | XVXXGFT | XVXXGFU | XVXXGFV | XVXXHDT | XVXXHDU | XVXXHDV | XVXXHET | XVXXHEU | XVXXHEV
XVXXHFT | XVXXHFU | XVXXHFV | XVXXIDT | XVXXIDU | XVXXIDV | XVXXIET | XVXXIEU | XVXXIEV | XVXXIFT | XVXXIFU
XVXXIFV | XVXYGDT | XVXYGDU | XVXYGDV | XVXYGET | XVXYGEU | XVXYGEV | XVXYGFT | XVXYGFU | XVXYGFV | XVXYHDT
XVXYHDU | XVXYHDV | XVXYHET | XVXYHEU | XVXYHEV | XVXYHFT | XVXYHFU | XVXYHFV | XVXYIDT | XVXYIDU | XVXYIDV
XVXYIET | XVXYIEU | XVXYIEV | XVXYIFT | XVXYIFU | XVXYIFV | XVXZGDT | XVXZGDU | XVXZGDV | XVXZGET | XVXZGEU
XVXZGEV | XVXZGFT | XVXZGFU | XVXZGFV | XVXZHDT | XVXZHDU | XVXZHDV | XVXZHET | XVXZHEU | XVXZHEV | XVXZHFT
XVXZHFU | XVXZHFV | XVXZIDT | XVXZIDU | XVXZIDV | XVXZIET | XVXZIEU | XVXZIEV | XVXZIFT | XVXZIFU | XVXZIFV
XVYWGDT | XVYWGDU | XVYWGDV | XVYWGET | XVYWGEU | XVYWGEV | XVYWGFT | XVYWGFU | XVYWGFV | XVYWHDT | XVYWHDU
XVYWHDV | XVYWHET | XVYWHEU | XVYWHEV | XVYWHFT | XVYWHFU | XVYWHFV | XVYWIDT | XVYWIDU | XVYWIDV | XVYWIET
XVYWIEU | XVYWIEV | XVYWIFT | XVYWIFU | XVYWIFV | XVYXGDT | XVYXGDU | XVYXGDV | XVYXGET | XVYXGEU | XVYXGEV
XVYXGFT | XVYXGFU | XVYXGFV | XVYXHDT | XVYXHDU | XVYXHDV | XVYXHET | XVYXHEU | XVYXHEV | XVYXHFT | XVYXHFU
XVYXHFV | XVYXIDT | XVYXIDU | XVYXIDV | XVYXIET | XVYXIEU | XVYXIEV | XVYXIFT | XVYXIFU | XVYXIFV | XVYYGDT
XVYYGDU | XVYYGDV | XVYYGET | XVYYGEU | XVYYGEV | XVYYGFT | XVYYGFU | XVYYGFV | XVYYHDT | XVYYHDU | XVYYHDV
XVYYHET | XVYYHEU | XVYYHEV | XVYYHFT | XVYYHFU | XVYYHFV | XVYYIDT | XVYYIDU | XVYYIDV | XVYYIET | XVYYIEU
XVYYIEV | XVYYIFT | XVYYIFU | XVYYIFV | XVYZGDT | XVYZGDU | XVYZGDV | XVYZGET | XVYZGEU | XVYZGEV | XVYZGFT
XVYZGFU | XVYZGFV | XVYZHDT | XVYZHDU | XVYZHDV | XVYZHET | XVYZHEU | XVYZHEV | XVYZHFT | XVYZHFU | XVYZHFV
XVYZIDT | XVYZIDU | XVYZIDV | XVYZIET | XVYZIEU | XVYZIEV | XVYZIFT | XVYZIFU | XVYZIFV | XVZWGDT | XVZWGDU
XVZWGDV | XVZWGET | XVZWGEU | XVZWGEV | XVZWGFT | XVZWGFU | XVZWGFV | XVZWHDT | XVZWHDU | XVZWHDV | XVZWHET
XVZWHEU | XVZWHEV | XVZWHFT | XVZWHFU | XVZWHFV | XVZWIDT | XVZWIDU | XVZWIDV | XVZWIET | XVZWIEU | XVZWIEV
XVZWIFT | XVZWIFU | XVZWIFV | XVZXGDT | XVZXGDU | XVZXGDV | XVZXGET | XVZXGEU | XVZXGEV | XVZXGFT | XVZXGFU
XVZXGFV | XVZXHDT | XVZXHDU | XVZXHDV | XVZXHET | XVZXHEU | XVZXHEV | XVZXHFT | XVZXHFU | XVZXHFV | XVZXIDT
XVZXIDU | XVZXIDV | XVZXIET | XVZXIEU | XVZXIEV | XVZXIFT | XVZXIFU | XVZXIFV | XVZYGDT | XVZYGDU | XVZYGDV
XVZYGET | XVZYGEU | XVZYGEV | XVZYGFT | XVZYGFU | XVZYGFV | XVZYHDT | XVZYHDU | XVZYHDV | XVZYHET | XVZYHEU
XVZYHEV | XVZYHFT | XVZYHFU | XVZYHFV | XVZYIDT | XVZYIDU | XVZYIDV | XVZYIET | XVZYIEU | XVZYIEV | XVZYIFT
XVZYIFU | XVZYIFV | XVZZGDT | XVZZGDU | XVZZGDV | XVZZGET | XVZZGEU | XVZZGEV | XVZZGFT | XVZZGFU | XVZZGFV
XVZZHDT | XVZZHDU | XVZZHDV | XVZZHET | XVZZHEU | XVZZHEV | XVZZHFT | XVZZHFU | XVZZHFV | XVZZIDT | XVZZIDU
XVZZIDV | XVZZIET | XVZZIEU | XVZZIEV | XVZZIFT | XVZZIFU | XVZZIFV | YTWWGDT | YTWWGDU | YTWWGDV | YTWWGET
YTWWGEU | YTWWGEV | YTWWGFT | YTWWGFU | YTWWGFV | YTWWHDT | YTWWHDU | YTWWHDV | YTWWHET | YTWWHEU | YTWWHEV
YTWWHFT | YTWWHFU | YTWWHFV | YTWWIDT | YTWWIDU | YTWWIDV | YTWWIET | YTWWIEU | YTWWIEV | YTWWIFT | YTWWIFU
YTWWIFV | YTWXGDT | YTWXGDU | YTWXGDV | YTWXGET | YTWXGEU | YTWXGEV | YTWXGFT | YTWXGFU | YTWXGFV | YTWXHDT
YTWXHDU | YTWXHDV | YTWXHET | YTWXHEU | YTWXHEV | YTWXHFT | YTWXHFU | YTWXHFV | YTWXIDT | YTWXIDU | YTWXIDV
YTWXIET | YTWXIEU | YTWXIEV | YTWXIFT | YTWXIFU | YTWXIFV | YTWYGDT | YTWYGDU | YTWYGDV | YTWYGET | YTWYGEU
YTWYGEV | YTWYGFT | YTWYGFU | YTWYGFV | YTWYHDT | YTWYHDU | YTWYHDV | YTWYHET | YTWYHEU | YTWYHEV | YTWYHFT
YTWYHFU | YTWYHFV | YTWYIDT | YTWYIDU | YTWYIDV | YTWYIET | YTWYIEU | YTWYIEV | YTWYIFT | YTWYIFU | YTWYIFV
YTWZGDT | YTWZGDU | YTWZGDV | YTWZGET | YTWZGEU | YTWZGEV | YTWZGFT | YTWZGFU | YTWZGFV | YTWZHDT | YTWZHDU
YTWZHDV | YTWZHET | YTWZHEU | YTWZHEV | YTWZHFT | YTWZHFU | YTWZHFV | YTWZIDT | YTWZIDU | YTWZIDV | YTWZIET
YTWZIEU | YTWZIEV | YTWZIFT | YTWZIFU | YTWZIFV | YTXWGDT | YTXWGDU | YTXWGDV | YTXWGET | YTXWGEU | YTXWGEV
YTXWGFT | YTXWGFU | YTXWGFV | YTXWHDT | YTXWHDU | YTXWHDV | YTXWHET | YTXWHEU | YTXWHEV | YTXWHFT | YTXWHFU
YTXWHFV | YTXWIDT | YTXWIDU | YTXWIDV | YTXWIET | YTXWIEU | YTXWIEV | YTXWIFT | YTXWIFU | YTXWIFV | YTXXGDT
YTXXGDU | YTXXGDV | YTXXGET | YTXXGEU | YTXXGEV | YTXXGFT | YTXXGFU | YTXXGFV | YTXXHDT | YTXXHDU | YTXXHDV
YTXXHET | YTXXHEU | YTXXHEV | YTXXHFT | YTXXHFU | YTXXHFV | YTXXIDT | YTXXIDU | YTXXIDV | YTXXIET | YTXXIEU
YTXXIEV | YTXXIFT | YTXXIFU | YTXXIFV | YTXYGDT | YTXYGDU | YTXYGDV | YTXYGET | YTXYGEU | YTXYGEV | YTXYGFT
YTXYGFU | YTXYGFV | YTXYHDT | YTXYHDU | YTXYHDV | YTXYHET | YTXYHEU | YTXYHEV | YTXYHFT | YTXYHFU | YTXYHFV
YTXYIDT | YTXYIDU | YTXYIDV | YTXYIET | YTXYIEU | YTXYIEV | YTXYIFT | YTXYIFU | YTXYIFV | YTXZGDT | YTXZGDU
YTXZGDV | YTXZGET | YTXZGEU | YTXZGEV | YTXZGFT | YTXZGFU | YTXZGFV | YTXZHDT | YTXZHDU | YTXZHDV | YTXZHET
YTXZHEU | YTXZHEV | YTXZHFT | YTXZHFU | YTXZHFV | YTXZIDT | YTXZIDU | YTXZIDV | YTXZIET | YTXZIEU | YTXZIEV
YTXZIFT | YTXZIFU | YTXZIFV | YTYWGDT | YTYWGDU | YTYWGDV | YTYWGET | YTYWGEU | YTYWGEV | YTYWGFT | YTYWGFU
YTYWGFV | YTYWHDT | YTYWHDU | YTYWHDV | YTYWHET | YTYWHEU | YTYWHEV | YTYWHFT | YTYWHFU | YTYWHFV | YTYWIDT
YTYWIDU | YTYWIDV | YTYWIET | YTYWIEU | YTYWIEV | YTYWIFT | YTYWIFU | YTYWIFV | YTYXGDT | YTYXGDU | YTYXGDV
YTYXGET | YTYXGEU | YTYXGEV | YTYXGFT | YTYXGFU | YTYXGFV | YTYXHDT | YTYXHDU | YTYXHDV | YTYXHET | YTYXHEU
YTYXHEV | YTYXHFT | YTYXHFU | YTYXHFV | YTYXIDT | YTYXIDU | YTYXIDV | YTYXIET | YTYXIEU | YTYXIEV | YTYXIFT
YTYXIFU | YTYXIFV | YTYYGDT | YTYYGDU | YTYYGDV | YTYYGET | YTYYGEU | YTYYGEV | YTYYGFT | YTYYGFU | YTYYGFV
YTYYHDT | YTYYHDU | YTYYHDV | YTYYHET | YTYYHEU | YTYYHEV | YTYYHFT | YTYYHFU | YTYYHFV | YTYYIDT | YTYYIDU
YTYYIDV | YTYYIET | YTYYIEU | YTYYIEV | YTYYIFT | YTYYIFU | YTYYIFV | YTYZGDT | YTYZGDU | YTYZGDV | YTYZGET
YTYZGEU | YTYZGEV | YTYZGFT | YTYZGFU | YTYZGFV | YTYZHDT | YTYZHDU | YTYZHDV | YTYZHET | YTYZHEU | YTYZHEV
YTYZHFT | YTYZHFU | YTYZHFV | YTYZIDT | YTYZIDU | YTYZIDV | YTYZIET | YTYZIEU | YTYZIEV | YTYZIFT | YTYZIFU
YTYZIFV | YTZWGDT | YTZWGDU | YTZWGDV | YTZWGET | YTZWGEU | YTZWGEV | YTZWGFT | YTZWGFU | YTZWGFV | YTZWHDT
YTZWHDU | YTZWHDV | YTZWHET | YTZWHEU | YTZWHEV | YTZWHFT | YTZWHFU | YTZWHFV | YTZWIDT | YTZWIDU | YTZWIDV
YTZWIET | YTZWIEU | YTZWIEV | YTZWIFT | YTZWIFU | YTZWIFV | YTZXGDT | YTZXGDU | YTZXGDV | YTZXGET | YTZXGEU
YTZXGEV | YTZXGFT | YTZXGFU | YTZXGFV | YTZXHDT | YTZXHDU | YTZXHDV | YTZXHET | YTZXHEU | YTZXHEV | YTZXHFT
YTZXHFU | YTZXHFV | YTZXIDT | YTZXIDU | YTZXIDV | YTZXIET | YTZXIEU | YTZXIEV | YTZXIFT | YTZXIFU | YTZXIFV
YTZYGDT | YTZYGDU | YTZYGDV | YTZYGET | YTZYGEU | YTZYGEV | YTZYGFT | YTZYGFU | YTZYGFV | YTZYHDT | YTZYHDU
YTZYHDV | YTZYHET | YTZYHEU | YTZYHEV | YTZYHFT | YTZYHFU | YTZYHFV | YTZYIDT | YTZYIDU | YTZYIDV | YTZYIET
YTZYIEU | YTZYIEV | YTZYIFT | YTZYIFU | YTZYIFV | YTZZGDT | YTZZGDU | YTZZGDV | YTZZGET | YTZZGEU | YTZZGEV
YTZZGFT | YTZZGFU | YTZZGFV | YTZZHDT | YTZZHDU | YTZZHDV | YTZZHET | YTZZHEU | YTZZHEV | YTZZHFT | YTZZHFU
YTZZHFV | YTZZIDT | YTZZIDU | YTZZIDV | YTZZIET | YTZZIEU | YTZZIEV | YTZZIFT | YTZZIFU | YTZZIFV | YUWWGDT
YUWWGDU | YUWWGDV | YUWWGET | YUWWGEU | YUWWGEV | YUWWGFT | YUWWGFU | YUWWGFV | YUWWHDT | YUWWHDU | YUWWHDV
YUWWHET | YUWWHEU | YUWWHEV | YUWWHFT | YUWWHFU | YUWWHFV | YUWWIDT | YUWWIDU | YUWWIDV | YUWWIET | YUWWIEU
YUWWIEV | YUWWIFT | YUWWIFU | YUWWIFV | YUWXGDT | YUWXGDU | YUWXGDV | YUWXGET | YUWXGEU | YUWXGEV | YUWXGFT
YUWXGFU | YUWXGFV | YUWXHDT | YUWXHDU | YUWXHDV | YUWXHET | YUWXHEU | YUWXHEV | YUWXHFT | YUWXHFU | YUWXHFV
YUWXIDT | YUWXIDU | YUWXIDV | YUWXIET | YUWXIEU | YUWXIEV | YUWXIFT | YUWXIFU | YUWXIFV | YUWYGDT | YUWYGDU
YUWYGDV | YUWYGET | YUWYGEU | YUWYGEV | YUWYGFT | YUWYGFU | YUWYGFV | YUWYHDT | YUWYHDU | YUWYHDV | YUWYHET
YUWYHEU | YUWYHEV | YUWYHFT | YUWYHFU | YUWYHFV | YUWYIDT | YUWYIDU | YUWYIDV | YUWYIET | YUWYIEU | YUWYIEV
YUWYIFT | YUWYIFU | YUWYIFV | YUWZGDT | YUWZGDU | YUWZGDV | YUWZGET | YUWZGEU | YUWZGEV | YUWZGFT | YUWZGFU
YUWZGFV | YUWZHDT | YUWZHDU | YUWZHDV | YUWZHET | YUWZHEU | YUWZHEV | YUWZHFT | YUWZHFU | YUWZHFV | YUWZIDT
YUWZIDU | YUWZIDV | YUWZIET | YUWZIEU | YUWZIEV | YUWZIFT | YUWZIFU | YUWZIFV | YUXWGDT | YUXWGDU | YUXWGDV
YUXWGET | YUXWGEU | YUXWGEV | YUXWGFT | YUXWGFU | YUXWGFV | YUXWHDT | YUXWHDU | YUXWHDV | YUXWHET | YUXWHEU
YUXWHEV | YUXWHFT | YUXWHFU | YUXWHFV | YUXWIDT | YUXWIDU | YUXWIDV | YUXWIET | YUXWIEU | YUXWIEV | YUXWIFT
YUXWIFU | YUXWIFV | YUXXGDT | YUXXGDU | YUXXGDV | YUXXGET | YUXXGEU | YUXXGEV | YUXXGFT | YUXXGFU | YUXXGFV
YUXXHDT | YUXXHDU | YUXXHDV | YUXXHET | YUXXHEU | YUXXHEV | YUXXHFT | YUXXHFU | YUXXHFV | YUXXIDT | YUXXIDU
YUXXIDV | YUXXIET | YUXXIEU | YUXXIEV | YUXXIFT | YUXXIFU | YUXXIFV | YUXYGDT | YUXYGDU | YUXYGDV | YUXYGET
YUXYGEU | YUXYGEV | YUXYGFT | YUXYGFU | YUXYGFV | YUXYHDT | YUXYHDU | YUXYHDV | YUXYHET | YUXYHEU | YUXYHEV
YUXYHFT | YUXYHFU | YUXYHFV | YUXYIDT | YUXYIDU | YUXYIDV | YUXYIET | YUXYIEU | YUXYIEV | YUXYIFT | YUXYIFU
YUXYIFV | YUXZGDT | YUXZGDU | YUXZGDV | YUXZGET | YUXZGEU | YUXZGEV | YUXZGFT | YUXZGFU | YUXZGFV | YUXZHDT
YUXZHDU | YUXZHDV | YUXZHET | YUXZHEU | YUXZHEV | YUXZHFT | YUXZHFU | YUXZHFV | YUXZIDT | YUXZIDU | YUXZIDV
YUXZIET | YUXZIEU | YUXZIEV | YUXZIFT | YUXZIFU | YUXZIFV | YUYWGDT | YUYWGDU | YUYWGDV | YUYWGET | YUYWGEU
YUYWGEV | YUYWGFT | YUYWGFU | YUYWGFV | YUYWHDT | YUYWHDU | YUYWHDV | YUYWHET | YUYWHEU | YUYWHEV | YUYWHFT
YUYWHFU | YUYWHFV | YUYWIDT | YUYWIDU | YUYWIDV | YUYWIET | YUYWIEU | YUYWIEV | YUYWIFT | YUYWIFU | YUYWIFV
YUYXGDT | YUYXGDU | YUYXGDV | YUYXGET | YUYXGEU | YUYXGEV | YUYXGFT | YUYXGFU | YUYXGFV | YUYXHDT | YUYXHDU
YUYXHDV | YUYXHET | YUYXHEU | YUYXHEV | YUYXHFT | YUYXHFU | YUYXHFV | YUYXIDT | YUYXIDU | YUYXIDV | YUYXIET
YUYXIEU | YUYXIEV | YUYXIFT | YUYXIFU | YUYXIFV | YUYYGDT | YUYYGDU | YUYYGDV | YUYYGET | YUYYGEU | YUYYGEV
YUYYGFT | YUYYGFU | YUYYGFV | YUYYHDT | YUYYHDU | YUYYHDV | YUYYHET | YUYYHEU | YUYYHEV | YUYYHFT | YUYYHFU
YUYYHFV | YUYYIDT | YUYYIDU | YUYYIDV | YUYYIET | YUYYIEU | YUYYIEV | YUYYIFT | YUYYIFU | YUYYIFV | YUYZGDT
YUYZGDU | YUYZGDV | YUYZGET | YUYZGEU | YUYZGEV | YUYZGFT | YUYZGFU | YUYZGFV | YUYZHDT | YUYZHDU | YUYZHDV
YUYZHET | YUYZHEU | YUYZHEV | YUYZHFT | YUYZHFU | YUYZHFV | YUYZIDT | YUYZIDU | YUYZIDV | YUYZIET | YUYZIEU
YUYZIEV | YUYZIFT | YUYZIFU | YUYZIFV | YUZWGDT | YUZWGDU | YUZWGDV | YUZWGET | YUZWGEU | YUZWGEV | YUZWGFT
YUZWGFU | YUZWGFV | YUZWHDT | YUZWHDU | YUZWHDV | YUZWHET | YUZWHEU | YUZWHEV | YUZWHFT | YUZWHFU | YUZWHFV
YUZWIDT | YUZWIDU | YUZWIDV | YUZWIET | YUZWIEU | YUZWIEV | YUZWIFT | YUZWIFU | YUZWIFV | YUZXGDT | YUZXGDU
YUZXGDV | YUZXGET | YUZXGEU | YUZXGEV | YUZXGFT | YUZXGFU | YUZXGFV | YUZXHDT | YUZXHDU | YUZXHDV | YUZXHET
YUZXHEU | YUZXHEV | YUZXHFT | YUZXHFU | YUZXHFV | YUZXIDT | YUZXIDU | YUZXIDV | YUZXIET | YUZXIEU | YUZXIEV
YUZXIFT | YUZXIFU | YUZXIFV | YUZYGDT | YUZYGDU | YUZYGDV | YUZYGET | YUZYGEU | YUZYGEV | YUZYGFT | YUZYGFU
YUZYGFV | YUZYHDT | YUZYHDU | YUZYHDV | YUZYHET | YUZYHEU | YUZYHEV | YUZYHFT | YUZYHFU | YUZYHFV | YUZYIDT
YUZYIDU | YUZYIDV | YUZYIET | YUZYIEU | YUZYIEV | YUZYIFT | YUZYIFU | YUZYIFV | YUZZGDT | YUZZGDU | YUZZGDV
YUZZGET | YUZZGEU | YUZZGEV | YUZZGFT | YUZZGFU | YUZZGFV | YUZZHDT | YUZZHDU | YUZZHDV | YUZZHET | YUZZHEU
YUZZHEV | YUZZHFT | YUZZHFU | YUZZHFV | YUZZIDT | YUZZIDU | YUZZIDV | YUZZIET | YUZZIEU | YUZZIEV | YUZZIFT
YUZZIFU | YUZZIFV | YVWWGDT | YVWWGDU | YVWWGDV | YVWWGET | YVWWGEU | YVWWGEV | YVWWGFT | YVWWGFU | YVWWGFV
YVWWHDT | YVWWHDU | YVWWHDV | YVWWHET | YVWWHEU | YVWWHEV | YVWWHFT | YVWWHFU | YVWWHFV | YVWWIDT | YVWWIDU
YVWWIDV | YVWWIET | YVWWIEU | YVWWIEV | YVWWIFT | YVWWIFU | YVWWIFV | YVWXGDT | YVWXGDU | YVWXGDV | YVWXGET
YVWXGEU | YVWXGEV | YVWXGFT | YVWXGFU | YVWXGFV | YVWXHDT | YVWXHDU | YVWXHDV | YVWXHET | YVWXHEU | YVWXHEV
YVWXHFT | YVWXHFU | YVWXHFV | YVWXIDT | YVWXIDU | YVWXIDV | YVWXIET | YVWXIEU | YVWXIEV | YVWXIFT | YVWXIFU
YVWXIFV | YVWYGDT | YVWYGDU | YVWYGDV | YVWYGET | YVWYGEU | YVWYGEV | YVWYGFT | YVWYGFU | YVWYGFV | YVWYHDT
YVWYHDU | YVWYHDV | YVWYHET | YVWYHEU | YVWYHEV | YVWYHFT | YVWYHFU | YVWYHFV | YVWYIDT | YVWYIDU | YVWYIDV
YVWYIET | YVWYIEU | YVWYIEV | YVWYIFT | YVWYIFU | YVWYIFV | YVWZGDT | YVWZGDU | YVWZGDV | YVWZGET | YVWZGEU
YVWZGEV | YVWZGFT | YVWZGFU | YVWZGFV | YVWZHDT | YVWZHDU | YVWZHDV | YVWZHET | YVWZHEU | YVWZHEV | YVWZHFT
YVWZHFU | YVWZHFV | YVWZIDT | YVWZIDU | YVWZIDV | YVWZIET | YVWZIEU | YVWZIEV | YVWZIFT | YVWZIFU | YVWZIFV
YVXWGDT | YVXWGDU | YVXWGDV | YVXWGET | YVXWGEU | YVXWGEV | YVXWGFT | YVXWGFU | YVXWGFV | YVXWHDT | YVXWHDU
YVXWHDV | YVXWHET | YVXWHEU | YVXWHEV | YVXWHFT | YVXWHFU | YVXWHFV | YVXWIDT | YVXWIDU | YVXWIDV | YVXWIET
YVXWIEU | YVXWIEV | YVXWIFT | YVXWIFU | YVXWIFV | YVXXGDT | YVXXGDU | YVXXGDV | YVXXGET | YVXXGEU | YVXXGEV
YVXXGFT | YVXXGFU | YVXXGFV | YVXXHDT | YVXXHDU | YVXXHDV | YVXXHET | YVXXHEU | YVXXHEV | YVXXHFT | YVXXHFU
YVXXHFV | YVXXIDT | YVXXIDU | YVXXIDV | YVXXIET | YVXXIEU | YVXXIEV | YVXXIFT | YVXXIFU | YVXXIFV | YVXYGDT
YVXYGDU | YVXYGDV | YVXYGET | YVXYGEU | YVXYGEV | YVXYGFT | YVXYGFU | YVXYGFV | YVXYHDT | YVXYHDU | YVXYHDV
YVXYHET | YVXYHEU | YVXYHEV | YVXYHFT | YVXYHFU | YVXYHFV | YVXYIDT | YVXYIDU | YVXYIDV | YVXYIET | YVXYIEU
YVXYIEV | YVXYIFT | YVXYIFU | YVXYIFV | YVXZGDT | YVXZGDU | YVXZGDV | YVXZGET | YVXZGEU | YVXZGEV | YVXZGFT
YVXZGFU | YVXZGFV | YVXZHDT | YVXZHDU | YVXZHDV | YVXZHET | YVXZHEU | YVXZHEV | YVXZHFT | YVXZHFU | YVXZHFV
YVXZIDT | YVXZIDU | YVXZIDV | YVXZIET | YVXZIEU | YVXZIEV | YVXZIFT | YVXZIFU | YVXZIFV | YVYWGDT | YVYWGDU
YVYWGDV | YVYWGET | YVYWGEU | YVYWGEV | YVYWGFT | YVYWGFU | YVYWGFV | YVYWHDT | YVYWHDU | YVYWHDV | YVYWHET
YVYWHEU | YVYWHEV | YVYWHFT | YVYWHFU | YVYWHFV | YVYWIDT | YVYWIDU | YVYWIDV | YVYWIET | YVYWIEU | YVYWIEV
YVYWIFT | YVYWIFU | YVYWIFV | YVYXGDT | YVYXGDU | YVYXGDV | YVYXGET | YVYXGEU | YVYXGEV | YVYXGFT | YVYXGFU
YVYXGFV | YVYXHDT | YVYXHDU | YVYXHDV | YVYXHET | YVYXHEU | YVYXHEV | YVYXHFT | YVYXHFU | YVYXHFV | YVYXIDT
YVYXIDU | YVYXIDV | YVYXIET | YVYXIEU | YVYXIEV | YVYXIFT | YVYXIFU | YVYXIFV | YVYYGDT | YVYYGDU | YVYYGDV
YVYYGET | YVYYGEU | YVYYGEV | YVYYGFT | YVYYGFU | YVYYGFV | YVYYHDT | YVYYHDU | YVYYHDV | YVYYHET | YVYYHEU
YVYYHEV | YVYYHFT | YVYYHFU | YVYYHFV | YVYYIDT | YVYYIDU | YVYYIDV | YVYYIET | YVYYIEU | YVYYIEV | YVYYIFT
YVYYIFU | YVYYIFV | YVYZGDT | YVYZGDU | YVYZGDV | YVYZGET | YVYZGEU | YVYZGEV | YVYZGFT | YVYZGFU | YVYZGFV
YVYZHDT | YVYZHDU | YVYZHDV | YVYZHET | YVYZHEU | YVYZHEV | YVYZHFT | YVYZHFU | YVYZHFV | YVYZIDT | YVYZIDU
YVYZIDV | YVYZIET | YVYZIEU | YVYZIEV | YVYZIFT | YVYZIFU | YVYZIFV | YVZWGDT | YVZWGDU | YVZWGDV | YVZWGET
YVZWGEU | YVZWGEV | YVZWGFT | YVZWGFU | YVZWGFV | YVZWHDT | YVZWHDU | YVZWHDV | YVZWHET | YVZWHEU | YVZWHEV
YVZWHFT | YVZWHFU | YVZWHFV | YVZWIDT | YVZWIDU | YVZWIDV | YVZWIET | YVZWIEU | YVZWIEV | YVZWIFT | YVZWIFU
YVZWIFV | YVZXGDT | YVZXGDU | YVZXGDV | YVZXGET | YVZXGEU | YVZXGEV | YVZXGFT | YVZXGFU | YVZXGFV | YVZXHDT
YVZXHDU | YVZXHDV | YVZXHET | YVZXHEU | YVZXHEV | YVZXHFT | YVZXHFU | YVZXHFV | YVZXIDT | YVZXIDU | YVZXIDV
YVZXIET | YVZXIEU | YVZXIEV | YVZXIFT | YVZXIFU | YVZXIFV | YVZYGDT | YVZYGDU | YVZYGDV | YVZYGET | YVZYGEU
YVZYGEV | YVZYGFT | YVZYGFU | YVZYGFV | YVZYHDT | YVZYHDU | YVZYHDV | YVZYHET | YVZYHEU | YVZYHEV | YVZYHFT
YVZYHFU | YVZYHFV | YVZYIDT | YVZYIDU | YVZYIDV | YVZYIET | YVZYIEU | YVZYIEV | YVZYIFT | YVZYIFU | YVZYIFV
YVZZGDT | YVZZGDU | YVZZGDV | YVZZGET | YVZZGEU | YVZZGEV | YVZZGFT | YVZZGFU | YVZZGFV | YVZZHDT | YVZZHDU
YVZZHDV | YVZZHET | YVZZHEU | YVZZHEV | YVZZHFT | YVZZHFU | YVZZHFV | YVZZIDT | YVZZIDU | YVZZIDV | YVZZIET
YVZZIEU | YVZZIEV | YVZZIFT | YVZZIFU | YVZZIFV | ZTWWGDT | ZTWWGDU | ZTWWGDV | ZTWWGET | ZTWWGEU | ZTWWGEV
ZTWWGFT | ZTWWGFU | ZTWWGFV | ZTWWHDT | ZTWWHDU | ZTWWHDV | ZTWWHET | ZTWWHEU | ZTWWHEV | ZTWWHFT | ZTWWHFU
ZTWWHFV | ZTWWIDT | ZTWWIDU | ZTWWIDV | ZTWWIET | ZTWWIEU | ZTWWIEV | ZTWWIFT | ZTWWIFU | ZTWWIFV | ZTWXGDT
ZTWXGDU | ZTWXGDV | ZTWXGET | ZTWXGEU | ZTWXGEV | ZTWXGFT | ZTWXGFU | ZTWXGFV | ZTWXHDT | ZTWXHDU | ZTWXHDV
ZTWXHET | ZTWXHEU | ZTWXHEV | ZTWXHFT | ZTWXHFU | ZTWXHFV | ZTWXIDT | ZTWXIDU | ZTWXIDV | ZTWXIET | ZTWXIEU
ZTWXIEV | ZTWXIFT | ZTWXIFU | ZTWXIFV | ZTWYGDT | ZTWYGDU | ZTWYGDV | ZTWYGET | ZTWYGEU | ZTWYGEV | ZTWYGFT
ZTWYGFU | ZTWYGFV | ZTWYHDT | ZTWYHDU | ZTWYHDV | ZTWYHET | ZTWYHEU | ZTWYHEV | ZTWYHFT | ZTWYHFU | ZTWYHFV
ZTWYIDT | ZTWYIDU | ZTWYIDV | ZTWYIET | ZTWYIEU | ZTWYIEV | ZTWYIFT | ZTWYIFU | ZTWYIFV | ZTWZGDT | ZTWZGDU
ZTWZGDV | ZTWZGET | ZTWZGEU | ZTWZGEV | ZTWZGFT | ZTWZGFU | ZTWZGFV | ZTWZHDT | ZTWZHDU | ZTWZHDV | ZTWZHET
ZTWZHEU | ZTWZHEV | ZTWZHFT | ZTWZHFU | ZTWZHFV | ZTWZIDT | ZTWZIDU | ZTWZIDV | ZTWZIET | ZTWZIEU | ZTWZIEV
ZTWZIFT | ZTWZIFU | ZTWZIFV | ZTXWGDT | ZTXWGDU | ZTXWGDV | ZTXWGET | ZTXWGEU | ZTXWGEV | ZTXWGFT | ZTXWGFU
ZTXWGFV | ZTXWHDT | ZTXWHDU | ZTXWHDV | ZTXWHET | ZTXWHEU | ZTXWHEV | ZTXWHFT | ZTXWHFU | ZTXWHFV | ZTXWIDT
ZTXWIDU | ZTXWIDV | ZTXWIET | ZTXWIEU | ZTXWIEV | ZTXWIFT | ZTXWIFU | ZTXWIFV | ZTXXGDT | ZTXXGDU | ZTXXGDV
ZTXXGET | ZTXXGEU | ZTXXGEV | ZTXXGFT | ZTXXGFU | ZTXXGFV | ZTXXHDT | ZTXXHDU | ZTXXHDV | ZTXXHET | ZTXXHEU
ZTXXHEV | ZTXXHFT | ZTXXHFU | ZTXXHFV | ZTXXIDT | ZTXXIDU | ZTXXIDV | ZTXXIET | ZTXXIEU | ZTXXIEV | ZTXXIFT
ZTXXIFU | ZTXXIFV | ZTXYGDT | ZTXYGDU | ZTXYGDV | ZTXYGET | ZTXYGEU | ZTXYGEV | ZTXYGFT | ZTXYGFU | ZTXYGFV
ZTXYHDT | ZTXYHDU | ZTXYHDV | ZTXYHET | ZTXYHEU | ZTXYHEV | ZTXYHFT | ZTXYHFU | ZTXYHFV | ZTXYIDT | ZTXYIDU
ZTXYIDV | ZTXYIET | ZTXYIEU | ZTXYIEV | ZTXYIFT | ZTXYIFU | ZTXYIFV | ZTXZGDT | ZTXZGDU | ZTXZGDV | ZTXZGET
ZTXZGEU | ZTXZGEV | ZTXZGFT | ZTXZGFU | ZTXZGFV | ZTXZHDT | ZTXZHDU | ZTXZHDV | ZTXZHET | ZTXZHEU | ZTXZHEV
ZTXZHFT | ZTXZHFU | ZTXZHFV | ZTXZIDT | ZTXZIDU | ZTXZIDV | ZTXZIET | ZTXZIEU | ZTXZIEV | ZTXZIFT | ZTXZIFU
ZTXZIFV | ZTYWGDT | ZTYWGDU | ZTYWGDV | ZTYWGET | ZTYWGEU | ZTYWGEV | ZTYWGFT | ZTYWGFU | ZTYWGFV | ZTYWHDT
ZTYWHDU | ZTYWHDV | ZTYWHET | ZTYWHEU | ZTYWHEV | ZTYWHFT | ZTYWHFU | ZTYWHFV | ZTYWIDT | ZTYWIDU | ZTYWIDV
ZTYWIET | ZTYWIEU | ZTYWIEV | ZTYWIFT | ZTYWIFU | ZTYWIFV | ZTYXGDT | ZTYXGDU | ZTYXGDV | ZTYXGET | ZTYXGEU
ZTYXGEV | ZTYXGFT | ZTYXGFU | ZTYXGFV | ZTYXHDT | ZTYXHDU | ZTYXHDV | ZTYXHET | ZTYXHEU | ZTYXHEV | ZTYXHFT
ZTYXHFU | ZTYXHFV | ZTYXIDT | ZTYXIDU | ZTYXIDV | ZTYXIET | ZTYXIEU | ZTYXIEV | ZTYXIFT | ZTYXIFU | ZTYXIFV
ZTYYGDT | ZTYYGDU | ZTYYGDV | ZTYYGET | ZTYYGEU | ZTYYGEV | ZTYYGFT | ZTYYGFU | ZTYYGFV | ZTYYHDT | ZTYYHDU
ZTYYHDV | ZTYYHET | ZTYYHEU | ZTYYHEV | ZTYYHFT | ZTYYHFU | ZTYYHFV | ZTYYIDT | ZTYYIDU | ZTYYIDV | ZTYYIET
ZTYYIEU | ZTYYIEV | ZTYYIFT | ZTYYIFU | ZTYYIFV | ZTYZGDT | ZTYZGDU | ZTYZGDV | ZTYZGET | ZTYZGEU | ZTYZGEV
ZTYZGFT | ZTYZGFU | ZTYZGFV | ZTYZHDT | ZTYZHDU | ZTYZHDV | ZTYZHET | ZTYZHEU | ZTYZHEV | ZTYZHFT | ZTYZHFU
ZTYZHFV | ZTYZIDT | ZTYZIDU | ZTYZIDV | ZTYZIET | ZTYZIEU | ZTYZIEV | ZTYZIFT | ZTYZIFU | ZTYZIFV | ZTZWGDT
ZTZWGDU | ZTZWGDV | ZTZWGET | ZTZWGEU | ZTZWGEV | ZTZWGFT | ZTZWGFU | ZTZWGFV | ZTZWHDT | ZTZWHDU | ZTZWHDV
ZTZWHET | ZTZWHEU | ZTZWHEV | ZTZWHFT | ZTZWHFU | ZTZWHFV | ZTZWIDT | ZTZWIDU | ZTZWIDV | ZTZWIET | ZTZWIEU
ZTZWIEV | ZTZWIFT | ZTZWIFU | ZTZWIFV | ZTZXGDT | ZTZXGDU | ZTZXGDV | ZTZXGET | ZTZXGEU | ZTZXGEV | ZTZXGFT
ZTZXGFU | ZTZXGFV | ZTZXHDT | ZTZXHDU | ZTZXHDV | ZTZXHET | ZTZXHEU | ZTZXHEV | ZTZXHFT | ZTZXHFU | ZTZXHFV
ZTZXIDT | ZTZXIDU | ZTZXIDV | ZTZXIET | ZTZXIEU | ZTZXIEV | ZTZXIFT | ZTZXIFU | ZTZXIFV | ZTZYGDT | ZTZYGDU
ZTZYGDV | ZTZYGET | ZTZYGEU | ZTZYGEV | ZTZYGFT | ZTZYGFU | ZTZYGFV | ZTZYHDT | ZTZYHDU | ZTZYHDV | ZTZYHET
ZTZYHEU | ZTZYHEV | ZTZYHFT | ZTZYHFU | ZTZYHFV | ZTZYIDT | ZTZYIDU | ZTZYIDV | ZTZYIET | ZTZYIEU | ZTZYIEV
ZTZYIFT | ZTZYIFU | ZTZYIFV | ZTZZGDT | ZTZZGDU | ZTZZGDV | ZTZZGET | ZTZZGEU | ZTZZGEV | ZTZZGFT | ZTZZGFU
ZTZZGFV | ZTZZHDT | ZTZZHDU | ZTZZHDV | ZTZZHET | ZTZZHEU | ZTZZHEV | ZTZZHFT | ZTZZHFU | ZTZZHFV | ZTZZIDT
ZTZZIDU | ZTZZIDV | ZTZZIET | ZTZZIEU | ZTZZIEV | ZTZZIFT | ZTZZIFU | ZTZZIFV | ZUWWGDT | ZUWWGDU | ZUWWGDV
ZUWWGET | ZUWWGEU | ZUWWGEV | ZUWWGFT | ZUWWGFU | ZUWWGFV | ZUWWHDT | ZUWWHDU | ZUWWHDV | ZUWWHET | ZUWWHEU
ZUWWHEV | ZUWWHFT | ZUWWHFU | ZUWWHFV | ZUWWIDT | ZUWWIDU | ZUWWIDV | ZUWWIET | ZUWWIEU | ZUWWIEV | ZUWWIFT
ZUWWIFU | ZUWWIFV | ZUWXGDT | ZUWXGDU | ZUWXGDV | ZUWXGET | ZUWXGEU | ZUWXGEV | ZUWXGFT | ZUWXGFU | ZUWXGFV
ZUWXHDT | ZUWXHDU | ZUWXHDV | ZUWXHET | ZUWXHEU | ZUWXHEV | ZUWXHFT | ZUWXHFU | ZUWXHFV | ZUWXIDT | ZUWXIDU
ZUWXIDV | ZUWXIET | ZUWXIEU | ZUWXIEV | ZUWXIFT | ZUWXIFU | ZUWXIFV | ZUWYGDT | ZUWYGDU | ZUWYGDV | ZUWYGET
ZUWYGEU | ZUWYGEV | ZUWYGFT | ZUWYGFU | ZUWYGFV | ZUWYHDT | ZUWYHDU | ZUWYHDV | ZUWYHET | ZUWYHEU | ZUWYHEV
ZUWYHFT | ZUWYHFU | ZUWYHFV | ZUWYIDT | ZUWYIDU | ZUWYIDV | ZUWYIET | ZUWYIEU | ZUWYIEV | ZUWYIFT | ZUWYIFU
ZUWYIFV | ZUWZGDT | ZUWZGDU | ZUWZGDV | ZUWZGET | ZUWZGEU | ZUWZGEV | ZUWZGFT | ZUWZGFU | ZUWZGFV | ZUWZHDT
ZUWZHDU | ZUWZHDV | ZUWZHET | ZUWZHEU | ZUWZHEV | ZUWZHFT | ZUWZHFU | ZUWZHFV | ZUWZIDT | ZUWZIDU | ZUWZIDV
ZUWZIET | ZUWZIEU | ZUWZIEV | ZUWZIFT | ZUWZIFU | ZUWZIFV | ZUXWGDT | ZUXWGDU | ZUXWGDV | ZUXWGET | ZUXWGEU
ZUXWGEV | ZUXWGFT | ZUXWGFU | ZUXWGFV | ZUXWHDT | ZUXWHDU | ZUXWHDV | ZUXWHET | ZUXWHEU | ZUXWHEV | ZUXWHFT
ZUXWHFU | ZUXWHFV | ZUXWIDT | ZUXWIDU | ZUXWIDV | ZUXWIET | ZUXWIEU | ZUXWIEV | ZUXWIFT | ZUXWIFU | ZUXWIFV
ZUXXGDT | ZUXXGDU | ZUXXGDV | ZUXXGET | ZUXXGEU | ZUXXGEV | ZUXXGFT | ZUXXGFU | ZUXXGFV | ZUXXHDT | ZUXXHDU
ZUXXHDV | ZUXXHET | ZUXXHEU | ZUXXHEV | ZUXXHFT | ZUXXHFU | ZUXXHFV | ZUXXIDT | ZUXXIDU | ZUXXIDV | ZUXXIET
ZUXXIEU | ZUXXIEV | ZUXXIFT | ZUXXIFU | ZUXXIFV | ZUXYGDT | ZUXYGDU | ZUXYGDV | ZUXYGET | ZUXYGEU | ZUXYGEV
ZUXYGFT | ZUXYGFU | ZUXYGFV | ZUXYHDT | ZUXYHDU | ZUXYHDV | ZUXYHET | ZUXYHEU | ZUXYHEV | ZUXYHFT | ZUXYHFU
ZUXYHFV | ZUXYIDT | ZUXYIDU | ZUXYIDV | ZUXYIET | ZUXYIEU | ZUXYIEV | ZUXYIFT | ZUXYIFU | ZUXYIFV | ZUXZGDT
ZUXZGDU | ZUXZGDV | ZUXZGET | ZUXZGEU | ZUXZGEV | ZUXZGFT | ZUXZGFU | ZUXZGFV | ZUXZHDT | ZUXZHDU | ZUXZHDV
ZUXZHET | ZUXZHEU | ZUXZHEV | ZUXZHFT | ZUXZHFU | ZUXZHFV | ZUXZIDT | ZUXZIDU | ZUXZIDV | ZUXZIET | ZUXZIEU
ZUXZIEV | ZUXZIFT | ZUXZIFU | ZUXZIFV | ZUYWGDT | ZUYWGDU | ZUYWGDV | ZUYWGET | ZUYWGEU | ZUYWGEV | ZUYWGFT
ZUYWGFU | ZUYWGFV | ZUYWHDT | ZUYWHDU | ZUYWHDV | ZUYWHET | ZUYWHEU | ZUYWHEV | ZUYWHFT | ZUYWHFU | ZUYWHFV
ZUYWIDT | ZUYWIDU | ZUYWIDV | ZUYWIET | ZUYWIEU | ZUYWIEV | ZUYWIFT | ZUYWIFU | ZUYWIFV | ZUYXGDT | ZUYXGDU
ZUYXGDV | ZUYXGET | ZUYXGEU | ZUYXGEV | ZUYXGFT | ZUYXGFU | ZUYXGFV | ZUYXHDT | ZUYXHDU | ZUYXHDV | ZUYXHET
ZUYXHEU | ZUYXHEV | ZUYXHFT | ZUYXHFU | ZUYXHFV | ZUYXIDT | ZUYXIDU | ZUYXIDV | ZUYXIET | ZUYXIEU | ZUYXIEV
ZUYXIFT | ZUYXIFU | ZUYXIFV | ZUYYGDT | ZUYYGDU | ZUYYGDV | ZUYYGET | ZUYYGEU | ZUYYGEV | ZUYYGFT | ZUYYGFU
ZUYYGFV | ZUYYHDT | ZUYYHDU | ZUYYHDV | ZUYYHET | ZUYYHEU | ZUYYHEV | ZUYYHFT | ZUYYHFU | ZUYYHFV | ZUYYIDT
ZUYYIDU | ZUYYIDV | ZUYYIET | ZUYYIEU | ZUYYIEV | ZUYYIFT | ZUYYIFU | ZUYYIFV | ZUYZGDT | ZUYZGDU | ZUYZGDV
ZUYZGET | ZUYZGEU | ZUYZGEV | ZUYZGFT | ZUYZGFU | ZUYZGFV | ZUYZHDT | ZUYZHDU | ZUYZHDV | ZUYZHET | ZUYZHEU
ZUYZHEV | ZUYZHFT | ZUYZHFU | ZUYZHFV | ZUYZIDT | ZUYZIDU | ZUYZIDV | ZUYZIET | ZUYZIEU | ZUYZIEV | ZUYZIFT
ZUYZIFU | ZUYZIFV | ZUZWGDT | ZUZWGDU | ZUZWGDV | ZUZWGET | ZUZWGEU | ZUZWGEV | ZUZWGFT | ZUZWGFU | ZUZWGFV
ZUZWHDT | ZUZWHDU | ZUZWHDV | ZUZWHET | ZUZWHEU | ZUZWHEV | ZUZWHFT | ZUZWHFU | ZUZWHFV | ZUZWIDT | ZUZWIDU
ZUZWIDV | ZUZWIET | ZUZWIEU | ZUZWIEV | ZUZWIFT | ZUZWIFU | ZUZWIFV | ZUZXGDT | ZUZXGDU | ZUZXGDV | ZUZXGET
ZUZXGEU | ZUZXGEV | ZUZXGFT | ZUZXGFU | ZUZXGFV | ZUZXHDT | ZUZXHDU | ZUZXHDV | ZUZXHET | ZUZXHEU | ZUZXHEV
ZUZXHFT | ZUZXHFU | ZUZXHFV | ZUZXIDT | ZUZXIDU | ZUZXIDV | ZUZXIET | ZUZXIEU | ZUZXIEV | ZUZXIFT | ZUZXIFU
ZUZXIFV | ZUZYGDT | ZUZYGDU | ZUZYGDV | ZUZYGET | ZUZYGEU | ZUZYGEV | ZUZYGFT | ZUZYGFU | ZUZYGFV | ZUZYHDT
ZUZYHDU | ZUZYHDV | ZUZYHET | ZUZYHEU | ZUZYHEV | ZUZYHFT | ZUZYHFU | ZUZYHFV | ZUZYIDT | ZUZYIDU | ZUZYIDV
ZUZYIET | ZUZYIEU | ZUZYIEV | ZUZYIFT | ZUZYIFU | ZUZYIFV | ZUZZGDT | ZUZZGDU | ZUZZGDV | ZUZZGET | ZUZZGEU
ZUZZGEV | ZUZZGFT | ZUZZGFU | ZUZZGFV | ZUZZHDT | ZUZZHDU | ZUZZHDV | ZUZZHET | ZUZZHEU | ZUZZHEV | ZUZZHFT
ZUZZHFU | ZUZZHFV | ZUZZIDT | ZUZZIDU | ZUZZIDV | ZUZZIET | ZUZZIEU | ZUZZIEV | ZUZZIFT | ZUZZIFU | ZUZZIFV
ZVWWGDT | ZVWWGDU | ZVWWGDV | ZVWWGET | ZVWWGEU | ZVWWGEV | ZVWWGFT | ZVWWGFU | ZVWWGFV | ZVWWHDT | ZVWWHDU
ZVWWHDV | ZVWWHET | ZVWWHEU | ZVWWHEV | ZVWWHFT | ZVWWHFU | ZVWWHFV | ZVWWIDT | ZVWWIDU | ZVWWIDV | ZVWWIET
ZVWWIEU | ZVWWIEV | ZVWWIFT | ZVWWIFU | ZVWWIFV | ZVWXGDT | ZVWXGDU | ZVWXGDV | ZVWXGET | ZVWXGEU | ZVWXGEV
ZVWXGFT | ZVWXGFU | ZVWXGFV | ZVWXHDT | ZVWXHDU | ZVWXHDV | ZVWXHET | ZVWXHEU | ZVWXHEV | ZVWXHFT | ZVWXHFU
ZVWXHFV | ZVWXIDT | ZVWXIDU | ZVWXIDV | ZVWXIET | ZVWXIEU | ZVWXIEV | ZVWXIFT | ZVWXIFU | ZVWXIFV | ZVWYGDT
ZVWYGDU | ZVWYGDV | ZVWYGET | ZVWYGEU | ZVWYGEV | ZVWYGFT | ZVWYGFU | ZVWYGFV | ZVWYHDT | ZVWYHDU | ZVWYHDV
ZVWYHET | ZVWYHEU | ZVWYHEV | ZVWYHFT | ZVWYHFU | ZVWYHFV | ZVWYIDT | ZVWYIDU | ZVWYIDV | ZVWYIET | ZVWYIEU
ZVWYIEV | ZVWYIFT | ZVWYIFU | ZVWYIFV | ZVWZGDT | ZVWZGDU | ZVWZGDV | ZVWZGET | ZVWZGEU | ZVWZGEV | ZVWZGFT
ZVWZGFU | ZVWZGFV | ZVWZHDT | ZVWZHDU | ZVWZHDV | ZVWZHET | ZVWZHEU | ZVWZHEV | ZVWZHFT | ZVWZHFU | ZVWZHFV
ZVWZIDT | ZVWZIDU | ZVWZIDV | ZVWZIET | ZVWZIEU | ZVWZIEV | ZVWZIFT | ZVWZIFU | ZVWZIFV | ZVXWGDT | ZVXWGDU
ZVXWGDV | ZVXWGET | ZVXWGEU | ZVXWGEV | ZVXWGFT | ZVXWGFU | ZVXWGFV | ZVXWHDT | ZVXWHDU | ZVXWHDV | ZVXWHET
ZVXWHEU | ZVXWHEV | ZVXWHFT | ZVXWHFU | ZVXWHFV | ZVXWIDT | ZVXWIDU | ZVXWIDV | ZVXWIET | ZVXWIEU | ZVXWIEV
ZVXWIFT | ZVXWIFU | ZVXWIFV | ZVXXGDT | ZVXXGDU | ZVXXGDV | ZVXXGET | ZVXXGEU | ZVXXGEV | ZVXXGFT | ZVXXGFU
ZVXXGFV | ZVXXHDT | ZVXXHDU | ZVXXHDV | ZVXXHET | ZVXXHEU | ZVXXHEV | ZVXXHFT | ZVXXHFU | ZVXXHFV | ZVXXIDT
ZVXXIDU | ZVXXIDV | ZVXXIET | ZVXXIEU | ZVXXIEV | ZVXXIFT | ZVXXIFU | ZVXXIFV | ZVXYGDT | ZVXYGDU | ZVXYGDV
ZVXYGET | ZVXYGEU | ZVXYGEV | ZVXYGFT | ZVXYGFU | ZVXYGFV | ZVXYHDT | ZVXYHDU | ZVXYHDV | ZVXYHET | ZVXYHEU
ZVXYHEV | ZVXYHFT | ZVXYHFU | ZVXYHFV | ZVXYIDT | ZVXYIDU | ZVXYIDV | ZVXYIET | ZVXYIEU | ZVXYIEV | ZVXYIFT
ZVXYIFU | ZVXYIFV | ZVXZGDT | ZVXZGDU | ZVXZGDV | ZVXZGET | ZVXZGEU | ZVXZGEV | ZVXZGFT | ZVXZGFU | ZVXZGFV
ZVXZHDT | ZVXZHDU | ZVXZHDV | ZVXZHET | ZVXZHEU | ZVXZHEV | ZVXZHFT | ZVXZHFU | ZVXZHFV | ZVXZIDT | ZVXZIDU
ZVXZIDV | ZVXZIET | ZVXZIEU | ZVXZIEV | ZVXZIFT | ZVXZIFU | ZVXZIFV | ZVYWGDT | ZVYWGDU | ZVYWGDV | ZVYWGET
ZVYWGEU | ZVYWGEV | ZVYWGFT | ZVYWGFU | ZVYWGFV | ZVYWHDT | ZVYWHDU | ZVYWHDV | ZVYWHET | ZVYWHEU | ZVYWHEV
ZVYWHFT | ZVYWHFU | ZVYWHFV | ZVYWIDT | ZVYWIDU | ZVYWIDV | ZVYWIET | ZVYWIEU | ZVYWIEV | ZVYWIFT | ZVYWIFU
ZVYWIFV | ZVYXGDT | ZVYXGDU | ZVYXGDV | ZVYXGET | ZVYXGEU | ZVYXGEV | ZVYXGFT | ZVYXGFU | ZVYXGFV | ZVYXHDT
ZVYXHDU | ZVYXHDV | ZVYXHET | ZVYXHEU | ZVYXHEV | ZVYXHFT | ZVYXHFU | ZVYXHFV | ZVYXIDT | ZVYXIDU | ZVYXIDV
ZVYXIET | ZVYXIEU | ZVYXIEV | ZVYXIFT | ZVYXIFU | ZVYXIFV | ZVYYGDT | ZVYYGDU | ZVYYGDV | ZVYYGET | ZVYYGEU
ZVYYGEV | ZVYYGFT | ZVYYGFU | ZVYYGFV | ZVYYHDT | ZVYYHDU | ZVYYHDV | ZVYYHET | ZVYYHEU | ZVYYHEV | ZVYYHFT
ZVYYHFU | ZVYYHFV | ZVYYIDT | ZVYYIDU | ZVYYIDV | ZVYYIET | ZVYYIEU | ZVYYIEV | ZVYYIFT | ZVYYIFU | ZVYYIFV
ZVYZGDT | ZVYZGDU | ZVYZGDV | ZVYZGET | ZVYZGEU | ZVYZGEV | ZVYZGFT | ZVYZGFU | ZVYZGFV | ZVYZHDT | ZVYZHDU
ZVYZHDV | ZVYZHET | ZVYZHEU | ZVYZHEV | ZVYZHFT | ZVYZHFU | ZVYZHFV | ZVYZIDT | ZVYZIDU | ZVYZIDV | ZVYZIET
ZVYZIEU | ZVYZIEV | ZVYZIFT | ZVYZIFU | ZVYZIFV | ZVZWGDT | ZVZWGDU | ZVZWGDV | ZVZWGET | ZVZWGEU | ZVZWGEV
ZVZWGFT | ZVZWGFU | ZVZWGFV | ZVZWHDT | ZVZWHDU | ZVZWHDV | ZVZWHET | ZVZWHEU | ZVZWHEV | ZVZWHFT | ZVZWHFU
ZVZWHFV | ZVZWIDT | ZVZWIDU | ZVZWIDV | ZVZWIET | ZVZWIEU | ZVZWIEV | ZVZWIFT | ZVZWIFU | ZVZWIFV | ZVZXGDT
ZVZXGDU | ZVZXGDV | ZVZXGET | ZVZXGEU | ZVZXGEV | ZVZXGFT | ZVZXGFU | ZVZXGFV | ZVZXHDT | ZVZXHDU | ZVZXHDV
ZVZXHET | ZVZXHEU | ZVZXHEV | ZVZXHFT | ZVZXHFU | ZVZXHFV | ZVZXIDT | ZVZXIDU | ZVZXIDV | ZVZXIET | ZVZXIEU
ZVZXIEV | ZVZXIFT | ZVZXIFU | ZVZXIFV | ZVZYGDT | ZVZYGDU | ZVZYGDV | ZVZYGET | ZVZYGEU | ZVZYGEV | ZVZYGFT
ZVZYGFU | ZVZYGFV | ZVZYHDT | ZVZYHDU | ZVZYHDV | ZVZYHET | ZVZYHEU | ZVZYHEV | ZVZYHFT | ZVZYHFU | ZVZYHFV
ZVZYIDT | ZVZYIDU | ZVZYIDV | ZVZYIET | ZVZYIEU | ZVZYIEV | ZVZYIFT | ZVZYIFU | ZVZYIFV | ZVZZGDT | ZVZZGDU
ZVZZGDV | ZVZZGET | ZVZZGEU | ZVZZGEV | ZVZZGFT | ZVZZGFU | ZVZZGFV | ZVZZHDT | ZVZZHDU | ZVZZHDV | ZVZZHET
ZVZZHEU | ZVZZHEV | ZVZZHFT | ZVZZHFU | ZVZZHFV | ZVZZIDT | ZVZZIDU | ZVZZIDV | ZVZZIET | ZVZZIEU | ZVZZIEV
ZVZZIFT | ZVZZIFU | ZVZZIFV | 